111111111111
100000000001
100000000001
10000000E001
10000C000001
111111111111
