111111111111111
100000000000001
10000000000P111
100000000C00011
100000000000011
111111111111111
