11111111111
10C0000C001
10111000001
101P100E001
1C101100001
10100000001
11111111111
