11111111111111111111
1P1C00000000000000E1
1C101111111111111111
101C00000000000000C1
10111111111111111101
1C0000000000000000C1
11111111111111111111
