1111111111111
1000000000001
1PPPPPPPPPP01
1000000000001
1E0000C111111
1111111111111
