1111111
1P00001
11111C1
1000001
1C11111
1000001
11111C1
1EC0001
1111111
