111111111111111
1P10C010C0100E1
10C010C0100C011
111111111111111
